//MAP CONVERTED BY dmm2tgm.py THIS HEADER COMMENT PREVENTS RECONVERSION, DO NOT REMOVE
"a" = (
/turf/closed/indestructible/riveted,
/area/pocket_dimension_storage)
"W" = (
/turf/open/indestructible/pocketspace,
/area/pocket_dimension_storage)

(1,1,1) = {"
a
a
a
"}
(2,1,1) = {"
a
W
a
"}
(3,1,1) = {"
a
a
a
"}
